16 8
7 4
5 1 1 1 1 1 1 9 1 1 1 1 1 1 1 6
4 0 0 0 0 0 0 0 0 0 0 0 0 0 0 3
4 0 0 0 0 0 0 0 0 0 0 0 0 0 0 3
11 0 0 0 0 0 0 0 0 0 0 0 0 0 0 12
4 0 0 0 0 0 0 0 0 0 0 0 0 0 0 3
4 0 0 0 0 0 0 0 0 0 0 0 0 0 0 3
4 0 0 0 0 0 0 0 0 0 0 0 0 0 0 3
8 2 2 2 2 2 2 10 2 2 2 2 2 2 2 7

